|                                                                    |4
|                                                                    |4
|                                                                    |4
|                                                                    |4
|                                                                    |4
|                                                                    |4
|                                                                    |4
|                                                                    |4
|                                                                    |4
|                                                                    |4
|                                                                    |4
|                                                                    |4
|                             __    __                           d   |4
|                            [        ]                              |4
|                             \[    ]/                               |4
|                             _|    |_                               |4
|                            [        ]                              |4
|                             \[    ]/                               |4
|                             _|    |_                               |4
|                            [        ]                              |4
|                             \[    ]/                               |4
|                             _|    |_                               |4
|                            [        ]                              |4
|                             \[    ]/                               |4
|                             _|    |_                               |4
|                            [        ]                              |4
|                             \[    ]/                               |4
|                             _|    |_                               |4
|                            [        ]                              |4
|                             \[    ]/                               |4
|                                                                    |4
|                                                                    |4
|                                                                    |4
|                                                                    |4
|                                                                    |4
|                                                                    |4
|                                                                    |4
|                                                                    |4
|                                                                    |4
|                                                                    |4

