----------------------------------------------------------------------
                                                                      
                                                                      
                                                                      
                                                                      
                            ________                                  
                           /=HANGAR=\                                 
                  /--------------------------\                        
                  |/======|==========|==[ ]--|                        
                  |||     |>-H    M-<|| / \ ||                        
                  |||      \--|  |--/ --   --|                        
                  |||                        |                        
                  |||                        |                        
                  |||\___                   /|                        
                  ||/%   |=====|    |------/%|                        
                  ||G=-||||               { }|                        
                  ||                         |                        
                  ||G=-||||               { }|                        
                  ||\%___|=====|    |------\%|                        
                  ||_/                      \|                        
                  ||                 _______||                        
                  ||                |F// \\F||                        
                  ||\_______        |_// \\_||                        
                  ||        |                |                        
                  ||        |                |                        
                  ||        |         >>> <<<|                        
                  ||        |         >W[ ]W<|                       
                  \------------|    |--------/                        
                             [x]    [x]                               
                                                                      
                                                                      
                                                                      
                                                                      
                                                                      
                                                                      
                                                                      
                                                                      
                                                                      
                                                                      
                                                                      