|                                                              |  |  |4
|             /|=OGNIWA========================================|==o--|4
|            |_| NR                >       |     /      STAL   |  |  |4
|            [ ] WAGA              >       |     /      KRZEM  |  |  |4
|              | POJEMNOSC         >       |     /      HELIUM |  |  |4
|            |=|                           |     /      TECHNET|  |  |4
|             \|===============================================|==o--|4
|                                                              |  |  |4
|                                                              |  |  |4
|             /|=LADOWNIE======================================|==o--|4
|            |_| NR                >       |     /      STAL   |  |  |4
|            [ ] WAGA              >       |     /      KRZEM  |  |  |4
|              | POJEMNOSC         >       |     /      HELIUM |  |  |4
|            |=|                           |     /      TECHNET|  |  |4
|             \|===============================================|==o--|4
|                                                              |  |  |4
|                                                              |  |  |4
|             /|=SILNIK========================================|==o--|4
|            |_| NR                >       |     /      STAL   |  |  |4
|            [ ] MOC               >       |     /      KRZEM  |  |  |4
|              |                           |     /      HELIUM |  |  |4
|            |=|                           |     /      TECHNET|  |  |4
|             \|===============================================|==o--|4
|                                                              |  |  |4
|                                                              |  |  |4
|             /|=PANCERZ=======================================|==o--|4
|            |_| NR                >       |     /      STAL   |  |  |4
|            [ ] WAGA              >       |     /      KRZEM  |  |  |4
|              | WYTRZYMALOSC      >       |     /      HELIUM |  |  |4
|            |=|                           |     /      TECHNET|  |  |4
|             \|===============================================|==o--|4
|                        \ ULEPSZENIA ROBOTA /                 |  |  |4
|                        |-------------------|                 |  |  |4
|                                                              |  |  |4
|                                                              |  |  |4
|                                                              |  |  |4
|               _________________________________________      |  |  |4
|              |                                         |     |  |  |4
|----// \\-----|-----------------FABRYKA-----------------|-----|  |  |4
|____// \\_____|_________________________________________|_____|  |  |4
