|-------------------------------FABRYKA------------------------------|4
|             /|===============================================|==o--|4
|            | |                             |    /     STAL   |  |  |4
|            | |                             |    /     KRZEM  |  |  |4
|            | |                             |    /     HELIUM |  |  |4
|            | |                             |    /     TECHNET|  |  |4
|             \|===============================================|==o--|4
|                                                              |  |  |4
|                                                              |  |  |4
|             /|===============================================|==o--|4
|            | |                             |    /     STAL   |  |  |4
|            | |                             |    /     KRZEM  |  |  |4
|            | |                             |    /     HELIUM |  |  |4
|            | |                             |    /     TECHNET|  |  |4
|             \|===============================================|==o--|4
|                                                              |  |  |4
|                                                              |  |  |4
|             /|===============================================|==o--|4
|            |_|                             |    /     STAL   |  |  |4
|            [ ]                             |    /     KRZEM  |  |  |4
|              |                             |    /     HELIUM |  |  |4
|            |=|                             |    /     TECHNET|  |  |4
|             \|===============================================|==o--|4
|                                                              |  |  |4
|                                                              |  |  |4
|             /|===============================================|==o--|4
|            | |                             |    /     STAL   |  |  |4
|            | |                             |    /     KRZEM  |  |  |4
|            | |                             |    /     HELIUM |  |  |4
|            | |                             |    /     TECHNET|  |  |4
|             \|===============================================|==o--|4
|                                                              |  |  |4
|                                                              |  |  |4
|             /|===============================================|==o--|4
|            | |                             |    /     STAL   |  |  |4
|            | |                             |    /     KRZEM  |  |  |4
|            | |                             |    /     HELIUM |  |  |4
|            | |                             |    /     TECHNET|  |  |4
|             \|===============================================|==o--|4
|                                                              |  |  |4