              ___                                                     |1
            //   ) )           //                                     |2
           //         ___     //  ___       __     _    __            |3
          //        //   ) ) // //   ) ) //   ) ) //   / /            |4
         //        //   / / // //   / / //   / / ((___/ /             |5
        ((____/ / ((___/ / // ((___/ / //   / /      / /              |6
                                                    / /               |7
                                                   / /                |8
                                                                      |4
